XPXXXXXXXXXXXXXXXXXXXXXXX
XPXXXXXXXXXXXXXXXXXXXXXXX
XPXXXXXXXXXXXXXXXXXXXXXXX
XPXXXXXXXXXXXXXXXXXXXXXXX
XPXXXXXXXXXXHHHXXXXXXXXXX
XPXXXXXXXXXXHHHXXXXXXXXXX
XPXXXXXXXXXXHHHXXXXXXXXXX
XPXXXXXXXXXXXXXXXXXXXXXXX
XPXXXXXXXXXXXXXXXXXXXXXXX
XPXXXXXXXXXXXXXXXXXXXXXXX
XPXXXXXXXXXXXXXXXXXXPPPPB
XPXXXXXXXXXXXXXXXXXXPXXXX
XPPPPPPPPXXXXXXXXXXXPXXXX
XXXXHHHHPXXXXXXXXXXXPXXXX
XXXXHHHHPXXXXXXXXXXXPXXXX
XXXXHHHHPXXXXXXXXXXXPXXXX
XXXPPPPPPXXXXXXXXXXXPXXXX
XXXPXXXXXXXXXXXXXXXXPXXXX
XXXPPPPPPPPPPPPPPPPPPXXXX
XXXXXXXXXXXXXXXXXXXXXXXXX
