XPPPXXXXXXXXXXXXXXXXXXXXX
XXXPXXXXXXXXXXXXXXXXXXXXX
XXXPPPXXXXXXXXXXXXXXXXXXX
XXXXXPXXXXXXXXXXXXXXXXXXX
XXXXXPXXXXXXXXXXXXXXXXXXX
XXXXXPHHHHHHHHXXXXXXXXXXX
XXXXXPPPPPPPPPPPPPPPXXXXX
XXXXXXHHHHHHHHXXXXXPXXXXX
XXXXXXXXXXXXXXXXXXXPXXXXX
XXXXXXXXXXXXXXXPPPPPXXXXX
XXXXXXXXXXXXXXXPXXXXXXXXX
XXXXXXXXXXXXXXXPXXXXXXXXX
XXXXXXXPPPPPPPPPXXXXXXXXX
XXXXXXXPXXXXXXXXXXXXXXXXX
XXXXXXXPXXXXXXXXXXXXXXXXX
XXXXXXXPXXXXXXXXXXXXXXXXX
XXXXPPPPXXXXXXXXXXXXXXXXX
XXXXPXXXXXXXXXXXXXXXXXXXX
XXXXPXXXXXXXXXXXXXXXXXXXX
XXXXBXXXXXXXXXXXXXXXXXXXX
